6 10
##########
#        #
# #### # #
# #    # #
#&  ##   #
##########
