15 22
#####............#####
#   #............#   #
#   ##############   #
#                    #
#     ##### ######   #
#     ##### ##       #
#  &  ##### ## ###   #
#     ##### ## ###   #
#     #####    ###   #
#     ############   #
####       #         #
....#      #    ###  #
.....#         ###   #
......#####    #     #
...........###########
