5 30
##############################
# & ##   ##   ##   ##   ##   #
# #    #    #    #    #    # #
#   ##   ##   ##   ##   ##   #
##############################
