9 5
#####
#   #
# # #
#&  #
## ##
#   #
# # #
#   #
#####
