25 5
#####
#   #
# # #
#&  #
## ##
## ##
#   #
# # #
#   #
## ##
## ##
#   #
# # #
#   #
## ##
## ##
#   #
# # #
#   #
## ##
## ##
#   #
# # #
#   #
#####
