5 8
########
#      #
# #### #
#&     #
########
