15 30
##############################
#                            #
#                            #
#                            #
#        ############        #
#        ############        #
#    &   ############        #
#        ############        #
#        ############        #
#        ############        #
#                            #
#                            #
#                            #
#                            #
##############################
