15 30
##############################
##                           #
#   #######  ###  #######  # #
#   #     #  ##  #   #     # #
##  #  ## #  #  #    #  #  # #
##  #  #  #    #  ####  #    #
##  #  #      #         #    #
##  #  ####   ###########  # #
#  ##     # #              # #
#  ## &   # # ###########    #
#  ##     # # # ###       ## #
#  ##     # # #     #  ##    #
#  #### ###   #######     #  #
#           #         ####   #
##############################
